...###
..#..#.#.##
.##..###..#
##........#
#...@..#..#
###...##..#
..#..#....#
.##.##.#.##
.#.##...##
.#.....##
.##.##..