...###
..##.#.##..
.##..###..#
##........#
#..#@#.#..#
#.##..##..#
..#..#....#
.##.##.#.##
.#......##
.#.....##
.#.##.##