...###.....
..##.#.###.
.##..###..#
##..##....#
#...@#.#..#
###.####..#
..#..#....#
.##.##.#.##
.#.##...##.
.#.....##..
.###..##...